      ###
      #.#
  #####.#####
 ##         ##
##  # # # #  ##
#             #
#     # #     #
#     $@$     #
####  ###  ####
   #### ####
        
