########
#  #   #
#   $  #
#  #$$ #
## #   #
#.. $# #
#..   @#
########