############
#      #   #
# # $      #
# ##$####$##
#     @#   #
###### $   #
    ## ######
    #  .....#
    # $######
    #  #
    ####