     ##########
  ####    #   ###
  #  # $$ #     #
  #$ #   $#     #
###  #  $ #     #
#   $#$  $#*.####
#   $   $ #.....#
# $$$# $@$ .*...#
#    #    #.....#
#################